#######
#T#   #
# #B# #
#P    #
#      #
#######