#######
#T#P  #
#  B  #
#      #
#######