########
#      T#
# #B#  #
#P     #
#      #
########